11111111111111111111111111111111111111111111111111111111111111111111111111111111111111111111111111111111111111111111111111
11111111111111111111111111111111111111111111111111111111111111111111111111111111111111111111111111111111111111111111111111
11111111111111111111111111111111111111111111111111111111111111111111111111111111111111111111111111111111111111111111111111
10111100000000000000000000000000000000000000000000000000000000000000000000000000000000000000000000000000000000000000000001
10111100000000000000000000000000000000000000000000000000000000000000000000000000000000000000000000000000000000000000000001
10111100000000000000000000000000000000000000000000000000000000000000000000000000000000000000000000000000000000000000000001
10000000000000000000000000000000000000000000000000000000000000000000000000000000000000000000000000000000000000000000111111
10111100000000000000000000000000000000000000000000000000000000000000000000000000000000000000000000000000000000000000000001
10111100000000000000000000000000000000000000000000000000000000000000000000000000000000000000000000000000000000000000000001
10111100000000000000000000000000000000000000000000000000000000000000000000000000000000000000000000000000000000000000000001
10111100000000000000000000000000000000000000000000000000000000000000000000000000000000000000000000000000000000000000000001
10111100000000000000000000000000000000000000000000000000000000000000000000000000000000000000000000000000000000000000000001
10111100000000000000000000000000000000000000000000000000000000000000000000000000000000000000000000000000000000000000000001
10111100000000000000000000000000000000000000000000000000000000000000000000000000000000000000000000000000000000000000000001
10111100000000000000000000000000000000000000000000000000000000000000000000000000000000000000000000000000000000000000000001
10111100000000000000000000000000000000000000000000000000000000000000000000000000000000000000000000000000000000000000000001
10111100000000000000000000000000000000000000000000000000000000000000000000000000000000000000000000000000000000000000000001
10111100000000000000000000000000000000000000000000000000000000000000000000000000000000000000000000000000000000000000000001
10111100000000000000000000000000000000000000000000000000000000000000000000000000000000000000000000000000000000000000000001
101111000000000000000000000000000000000000000000000000000000000000C1111000000000000000000000000000000000000000000000000001
101111000000000000000000000000000000000000000000000000000000000000E1111C00000000000000000000000000000000000000000000000001
101111000000000000000000000000000000000000000000000000000000000000C000P000000000000000000000000000000000000000000000000001
10111100000000000000000000000000000000000000000000000000000000000000000000000000000000000000000000000000000000000000000001
10111100000000000000000000000000000000000000000000000000000000000000000000000000000000000000000000000000000000000000000001
10111100000000000000000000000000000000000000000000000000000000000000000000000000000000000000000000000000000000000000000001
10111100000000000000000000000000000000000000000000000000000000000000000000000000000000000000000000000000000000000000000001
10111100000000000000000000000000000000000000000000000000000000000000000000000000000000000000000000000000000000000000000001
10111100000000000000000000000000000000000000000000000000000000000000000000000000000000000000000000000000000000000000000001
10111100000000000000000000000000000000000000000000000000000000000000000000000000000000000000000000000000000000000000000001
10111100000000000000000000000000000000000000000000000000000000000000000000000000000000000000000000000000000000000000000001
11111111111111111111111111111111111111111111111111111111111111111111111111111111111111111111111111111111111111111111111111
11111111111111111111111111111111111111111111111111111111111111111111111111111111111111111111111111111111111111111111111111