1111111111111111111111
1011111110000001000001
100111111011110100E001
1000111110110000000001
1000011110110101110111
1000001110000101110111
1000000111111101110111
1000000011111101110111
1000000000000001110111
1000C000000000P1110111
1000000011111111110111
1000000111111111110111
1000001111111111110111
1000011111111111100111
1000000000000001000111
1001111111000000000111
1011111111000001111111
1111111111111111111111