11111111111111111111111111
11111111111000100010001011
11111111111010101010101011
11111111110010001000100011
1101C101110111111111111111
11C0E0C1110000010001000111
1101C1000000010001000100P1
11111111111111111111111111