11111111
1E000001
10000001
10000001
10000001
10000001
10000001
10C00P01
11111111