11111111111
100C0111111
1PE10111111
11111111111
10000111111
11111111111